AAAACCCACTG -> AAACCCACTGG
AAAACCCTAGC -> AAACCCTAGCA
AAAACGGTAAA -> AAACGGTAAAC
AAAAGACATGC -> AAAGACATGCT
AAAATGGTATG -> AAATGGTATGG
AAACACTTCGC -> AACACTTCGCA
AAACCCACTGG -> AACCCACTGGT
AAACCCTAGCA -> AACCCTAGCAC
AAACCGAAGAA -> AACCGAAGAAG
AAACCGGCTAA -> AACCGGCTAAC
AAACCGGTATG -> AACCGGTATGC
AAACCTGATAG -> AACCTGATAGC
AAACGACGATC -> AACGACGATCT
AAACGGTAAAC -> AACGGTAAACG
AAACTCCTGCA -> AACTCCTGCAC
AAAGACATGCT -> AAGACATGCTC
AAAGTCAAACA -> AAGTCAAACAC
AAATCACGTCC -> AATCACGTCCA
AAATCATAGTG -> AATCATAGTGG
AAATCGGACAG -> AATCGGACAGG
AAATGGGGAGC -> AATGGGGAGCT
AAATGGTATGG -> AATGGTATGGT
AACAACCAAAA -> ACAACCAAAAT
AACAATCTTTG -> ACAATCTTTGG
AACACAGATGC -> ACACAGATGCG
AACACATCTTA -> ACACATCTTAA
AACACTTCGCA -> ACACTTCGCAG
AACCAAAATGG -> ACCAAAATGGT
AACCAATCCTT -> ACCAATCCTTG
AACCATGCCTT -> ACCATGCCTTG
AACCCACTGGT -> ACCCACTGGTC
AACCCTAGCAC -> ACCCTAGCACC
AACCGAAGAAG -> ACCGAAGAAGA
AACCGGCTAAC -> ACCGGCTAACG
AACCGGTATGC -> ACCGGTATGCA
AACCTCGCTTT -> ACCTCGCTTTT
AACCTGATAGC -> ACCTGATAGCC
AACGAACCAAT -> ACGAACCAATC
AACGACGATCT -> ACGACGATCTA
AACGACTAGTA -> ACGACTAGTAG
AACGGACGACG -> ACGGACGACGA
AACGGACTTGC -> ACGGACTTGCG
AACGGTAAACG -> ACGGTAAACGA
AACGTATACCG -> ACGTATACCGC
AACGTGTGCGT -> ACGTGTGCGTA
AACTCCCTGGG -> ACTCCCTGGGA
AACTCCTGCAC -> ACTCCTGCACA
AACTCGAGAGG -> ACTCGAGAGGC
AACTGCTAATC -> ACTGCTAATCT
AACTGTTCGAT -> ACTGTTCGATG
AACTTTTTTCC -> ACTTTTTTCCT
AAGAAGACTTG -> AGAAGACTTGC
AAGACATGCTC -> AGACATGCTCG
AAGACTCGTAT -> AGACTCGTATA
AAGACTTGCCG -> AGACTTGCCGC
AAGCAATGAAA -> AGCAATGAAAT
AAGCGGCGTTG -> AGCGGCGTTGC
AAGCTAATTGT -> AGCTAATTGTC
AAGCTTAGAGA -> AGCTTAGAGAA
AAGGAAGGGAT -> AGGAAGGGATG
AAGGACTCGCC -> AGGACTCGCCC
AAGGGATGAAA -> AGGGATGAAAA
AAGGGATGGTC -> AGGGATGGTCC
AAGGGTAAGTG -> AGGGTAAGTGT
AAGGGTACCTT -> AGGGTACCTTG
AAGGGTCGGGT -> AGGGTCGGGTC
AAGGTAACACA -> AGGTAACACAT
AAGGTGCTCCA -> AGGTGCTCCAA
AAGTCAAACAC -> AGTCAAACACT
AAGTCATTGAA -> AGTCATTGAAG
AAGTGGCGGTA -> AGTGGCGGTAC
AAGTGGGCGAT -> AGTGGGCGATC
AAGTGTTTCGG -> AGTGTTTCGGT
AAGTTAAAGTC -> AGTTAAAGTCA
AAGTTGAGCCT -> AGTTGAGCCTC
AAGTTTCGCGG -> AGTTTCGCGGA
AATACAGAGAA -> ATACAGAGAAC
AATAGATTACG -> ATAGATTACGC
AATATGCCTGC -> ATATGCCTGCG
AATATGGGTAT -> ATATGGGTATT
AATCACGTCCA -> ATCACGTCCAT
AATCATAGTGG -> ATCATAGTGGC
AATCCTTGCCT -> ATCCTTGCCTG
AATCGGACAGG -> ATCGGACAGGA
AATCGGCACTG -> ATCGGCACTGT
AATCGTCCCAA -> ATCGTCCCAAT
AATCTTCCGCT -> ATCTTCCGCTT
AATCTTTGGTA -> ATCTTTGGTAT
AATGAAATCAT -> ATGAAATCATA
AATGCCAAGTG -> ATGCCAAGTGG
AATGGGGAGCT -> ATGGGGAGCTA
AATGGTACTGG -> ATGGTACTGGG
AATGGTATGGT -> ATGGTATGGTA
AATTACCGTGA -> ATTACCGTGAA
AATTCCACGGA -> ATTCCACGGAG
AATTCTCATTG -> ATTCTCATTGC
AATTGAGAAAT -> ATTGAGAAATC
AATTGTCTGGG -> ATTGTCTGGGA
ACAACAACCAA -> CAACAACCAAA
ACAACCAAAAT -> CAACCAAAATG
ACAAGCTTAGA -> CAAGCTTAGAG
ACAAGGTGCTC -> CAAGGTGCTCC
ACAATCTTTGG -> CAATCTTTGGT
ACACAGATGCG -> CACAGATGCGT
ACACATCTTAA -> CACATCTTAAC
ACACGGCCGCG -> CACGGCCGCGC
ACACGTGTCTA -> CACGTGTCTAC
ACACTTAAAAC -> CACTTAAAACC
ACACTTCGCAG -> CACTTCGCAGC
ACAGAGAACTC -> CAGAGAACTCG
ACAGATGCGTC -> CAGATGCGTCG
ACAGCATGGCG -> CAGCATGGCGT
ACAGGATTTGC -> CAGGATTTGCC
ACAGTAATACA -> CAGTAATACAG
ACATCTTAACG -> CATCTTAACGT
ACATGCTCGTA -> CATGCTCGTAA
ACCAAAATGGT -> CCAAAATGGTA
ACCAATCCTTG -> CCAATCCTTGC
ACCACGTAGGA -> CCACGTAGGAG
ACCACTCACTA -> CCACTCACTAG
ACCACTGAGGA -> CCACTGAGGAG
ACCATGAGTAC -> CCATGAGTACT
ACCATGCCTTG -> CCATGCCTTGC
ACCATTCGACT -> CCATTCGACTG
ACCCACTGGTC -> CCCACTGGTCG
ACCCAGTCAAT -> CCCAGTCAATC
ACCCGCCACCG -> CCCGCCACCGC
ACCCTAGCACC -> CCCTAGCACCT
ACCCTTGGAGT -> CCCTTGGAGTT
ACCGAAGAAGA -> CCGAAGAAGAC
ACCGCACCCGC -> CCGCACCCGCC
ACCGCAGACGC -> CCGCAGACGCT
ACCGCGCGCTG -> CCGCGCGCTGC
ACCGGCTAACG -> CCGGCTAACGA
ACCGGTATGCA -> CCGGTATGCAG
ACCGTGAAGGG -> CCGTGAAGGGT
ACCTAAGACTC -> CCTAAGACTCG
ACCTAAGGTAA -> CCTAAGGTAAC
ACCTCAAAACC -> CCTCAAAACCC
ACCTCGCTTTT -> CCTCGCTTTTA
ACCTCTTCCTT -> CCTCTTCCTTG
ACCTGATAGCC -> CCTGATAGCCA
ACCTTGGTGTG -> CCTTGGTGTGC
ACGAACCAATC -> CGAACCAATCC
ACGAAGTGGCG -> CGAAGTGGCGG
ACGAATTCTCA -> CGAATTCTCAT
ACGACGAATTC -> CGACGAATTCT
ACGACGATCTA -> CGACGATCTAT
ACGACTAGTAG -> CGACTAGTAGA
ACGAGTTGATT -> CGAGTTGATTG
ACGATCTATTC -> CGATCTATTCC
ACGATGTGTTA -> CGATGTGTTAC
ACGATGTTCCC -> CGATGTTCCCC
ACGCGGCATGC -> CGCGGCATGCC
ACGCGTGCTGC -> CGCGTGCTGCA
ACGCTGACGGC -> CGCTGACGGCG
ACGCTTGAACT -> CGCTTGAACTG
ACGGAACTTTT -> CGGAACTTTTT
ACGGACGACGA -> CGGACGACGAA
ACGGACTAGAA -> CGGACTAGAAG
ACGGACTTGCG -> CGGACTTGCGT
ACGGAGCATAT -> CGGAGCATATC
ACGGCCGCGCT -> CGGCCGCGCTC
ACGGCGAATGC -> CGGCGAATGCC
ACGGGCTGGTA -> CGGGCTGGTAT
ACGGTAAACGA -> CGGTAAACGAC
ACGGTAACTCC -> CGGTAACTCCC
ACGGTACTACC -> CGGTACTACCC
ACGTAGGAGGA -> CGTAGGAGGAG
ACGTATACCGC -> CGTATACCGCG
ACGTCCATATG -> CGTCCATATGC
ACGTGAATGGT -> CGTGAATGGTA
ACGTGTCTACT -> CGTGTCTACTT
ACGTGTGCGTA -> CGTGTGCGTAC
ACGTTATCCCA -> CGTTATCCCAC
ACGTTGGTATA -> CGTTGGTATAC
ACGTTTTACGC -> CGTTTTACGCG
ACTAACGGACG -> CTAACGGACGA
ACTACCCTTGG -> CTACCCTTGGA
ACTAGAAGGAC -> CTAGAAGGACT
ACTAGTAGACA -> CTAGTAGACAC
ACTAGTCAAGC -> CTAGTCAAGCT
ACTATGACGAT -> CTATGACGATG
ACTATGCCCCG -> CTATGCCCCGA
ACTATTCATAG -> CTATTCATAGA
ACTCACTAGTC -> CTCACTAGTCA
ACTCAGGAGTT -> CTCAGGAGTTG
ACTCCCTGGGA -> CTCCCTGGGAT
ACTCCTGCACA -> CTCCTGCACAG
ACTCGAGAGGC -> CTCGAGAGGCG
ACTCGATGAAA -> CTCGATGAAAT
ACTCGCCCCGC -> CTCGCCCCGCC
ACTCGTATAGG -> CTCGTATAGGC
ACTCTCGGACC -> CTCTCGGACCC
ACTCTGACTAA -> CTCTGACTAAC
ACTGAGGAGTC -> CTGAGGAGTCG
ACTGAGTTTAA -> CTGAGTTTAAC
ACTGCGTGCAC -> CTGCGTGCACT
ACTGCTAATCT -> CTGCTAATCTT
ACTGCTACTTC -> CTGCTACTTCC
ACTGGATCGAC -> CTGGATCGACC
ACTGGGTCTGC -> CTGGGTCTGCG
ACTGGTCGGTT -> CTGGTCGGTTA
ACTGTCTACGT -> CTGTCTACGTT
ACTGTTCGATG -> CTGTTCGATGG
ACTTAAAACCC -> CTTAAAACCCT
ACTTAAGTTAA -> CTTAAGTTAAA
ACTTATAGCCA -> CTTATAGCCAA
ACTTCCACGGG -> CTTCCACGGGC
ACTTCGCAGCG -> CTTCGCAGCGT
ACTTGCCGCAA -> CTTGCCGCAAT
ACTTGCGTCGA -> CTTGCGTCGAG
ACTTTCTTTAC -> CTTTCTTTACG
ACTTTTTTCCT -> CTTTTTTCCTG
AGAAATCACGT -> GAAATCACGTC
AGAAATCGGAC -> GAAATCGGACA
AGAACTCGAGA -> GAACTCGAGAG
AGAAGACTTGC -> GAAGACTTGCC
AGAAGGACTCG -> GAAGGACTCGC
AGAATATGGGT -> GAATATGGGTA
AGACACGTGTC -> GACACGTGTCT
AGACATGCTCG -> GACATGCTCGT
AGACGCTGACG -> GACGCTGACGG
AGACTCAGGAG -> GACTCAGGAGT
AGACTCGTATA -> GACTCGTATAG
AGACTTGCCGC -> GACTTGCCGCA
AGAGAAATCAC -> GAGAAATCACG
AGAGAACTCGA -> GAGAACTCGAG
AGAGGCGTATG -> GAGGCGTATGG
AGAGTCAGGGA -> GAGTCAGGGAA
AGATACGAAGT -> GATACGAAGTG
AGATCGGTGAG -> GATCGGTGAGT
AGATGCGTCGC -> GATGCGTCGCG
AGATTACGCGG -> GATTACGCGGC
AGCAATGAAAT -> GCAATGAAATC
AGCACCTCAAA -> GCACCTCAAAA
AGCATATCAAG -> GCATATCAAGG
AGCATGGCGTA -> GCATGGCGTAT
AGCCAACCTCG -> GCCAACCTCGC
AGCCAAGCAAT -> GCCAAGCAATG
AGCCAGCGAGG -> GCCAGCGAGGG
AGCCTCTCTCA -> GCCTCTCTCAT
AGCCTTGACAG -> GCCTTGACAGT
AGCGAGGGCCA -> GCGAGGGCCAA
AGCGGCGTTGC -> GCGGCGTTGCA
AGCGTGAAAAG -> GCGTGAAAAGA
AGCTAATTGTC -> GCTAATTGTCT
AGCTACCACGT -> GCTACCACGTA
AGCTATATTAG -> GCTATATTAGG
AGCTTAGAGAA -> GCTTAGAGAAA
AGGAAGGGATG -> GGAAGGGATGG
AGGACTCGCCC -> GGACTCGCCCC
AGGAGGAGTCC -> GGAGGAGTCCT
AGGAGTCCTGC -> GGAGTCCTGCC
AGGAGTCGTGA -> GGAGTCGTGAC
AGGAGTTGACA -> GGAGTTGACAC
AGGATTTGCCC -> GGATTTGCCCC
AGGCGTATGGG -> GGCGTATGGGG
AGGCGTTCGCG -> GGCGTTCGCGA
AGGCTATGTAC -> GGCTATGTACT
AGGGAATTGAG -> GGGAATTGAGA
AGGGAGTTCGT -> GGGAGTTCGTG
AGGGATGAAAA -> GGGATGAAAAC
AGGGATGGTCC -> GGGATGGTCCT
AGGGCCAAACC -> GGGCCAAACCG
AGGGTAAGTGT -> GGGTAAGTGTT
AGGGTACCTTG -> GGGTACCTTGG
AGGGTCGGGTC -> GGGTCGGGTCG
AGGTAAACCTG -> GGTAAACCTGA
AGGTAACACAT -> GGTAACACATC
AGGTGCTCCAA -> GGTGCTCCAAG
AGGTGGGGTTA -> GGTGGGGTTAG
AGTAAACTCCT -> GTAAACTCCTG
AGTAATACAGA -> GTAATACAGAG
AGTACGGTACT -> GTACGGTACTA
AGTACTATGAC -> GTACTATGACG
AGTACTATGCC -> GTACTATGCCC
AGTAGACACGT -> GTAGACACGTG
AGTAGGCGTTC -> GTAGGCGTTCG
AGTCAAACACT -> GTCAAACACTT
AGTCAAGCTAA -> GTCAAGCTAAT
AGTCAATCGGC -> GTCAATCGGCA
AGTCAGGGAAT -> GTCAGGGAATT
AGTCAGGGAGT -> GTCAGGGAGTT
AGTCATTGAAG -> GTCATTGAAGG
AGTCCTGCCAA -> GTCCTGCCAAT
AGTCGTGACGG -> GTCGTGACGGA
AGTCTACTCGA -> GTCTACTCGAT
AGTGAATAGAT -> GTGAATAGATT
AGTGAGTACTA -> GTGAGTACTAT
AGTGCGGTACC -> GTGCGGTACCA
AGTGCTCATTC -> GTGCTCATTCC
AGTGGCAGATA -> GTGGCAGATAC
AGTGGCGGTAC -> GTGGCGGTACT
AGTGGGCGATC -> GTGGGCGATCC
AGTGTTGGGCT -> GTGTTGGGCTC
AGTGTTTCGGT -> GTGTTTCGGTC
AGTTAAAGTCA -> GTTAAAGTCAA
AGTTAGAGTCA -> GTTAGAGTCAG
AGTTCGTGAAC -> GTTCGTGAACA
AGTTGAAACCG -> GTTGAAACCGA,GTTGAAACCGG
AGTTGACACGG -> GTTGACACGGC
AGTTGAGCCTC -> GTTGAGCCTCT
AGTTGATTGGC -> GTTGATTGGCT
AGTTTAACAAT -> GTTTAACAATC
AGTTTCGCGGA -> GTTTCGCGGAA
AGTTTCTCCGC -> GTTTCTCCGCT
ATAACGGACTT -> TAACGGACTTG
ATACACTTAAA -> TACACTTAAAA
ATACAGAGAAC -> TACAGAGAACT
ATACCGCGCGC -> TACCGCGCGCT
ATACGAAGTGG -> TACGAAGTGGC
ATACTGCTACT -> TACTGCTACTT
ATACTTAAGTT -> TACTTAAGTTA
ATAGAATATGG -> TAGAATATGGG
ATAGACTCAGG -> TAGACTCAGGA
ATAGATTACGC -> TAGATTACGCG
ATAGCCAACCT -> TAGCCAACCTC
ATAGCCAGCGA -> TAGCCAGCGAG
ATAGGCTATGT -> TAGGCTATGTA
ATAGTGGCAGA -> TAGTGGCAGAT
ATATATCGGAA -> TATATCGGAAG
ATATCAAGGGA -> TATCAAGGGAT
ATATCGGAAGC -> TATCGGAAGCG
ATATGCCTGCG -> TATGCCTGCGA
ATATGCTGGCG -> TATGCTGGCGG
ATATGGGTATT -> TATGGGTATTC
ATATTAGGTAA -> TATTAGGTAAA
ATCAAGGGATG -> TCAAGGGATGA
ATCACGTCCAT -> TCACGTCCATA
ATCATAGTGGC -> TCATAGTGGCA
ATCCACGTTAT -> TCCACGTTATC
ATCCCACGAGT -> TCCCACGAGTT
ATCCCCCGTAT -> TCCCCCGTATA
ATCCTTGCCTG -> TCCTTGCCTGC
ATCGACCGCAC -> TCGACCGCACC
ATCGGAAGCGG -> TCGGAAGCGGC
ATCGGACAGGA -> TCGGACAGGAT
ATCGGCACTGT -> TCGGCACTGTC
ATCGGTGAGTT -> TCGGTGAGTTG
ATCGTCCCAAT -> TCGTCCCAATT
ATCTATTCCTC -> TCTATTCCTCG
ATCTCTGGCCT -> TCTCTGGCCTC
ATCTTAACGTG -> TCTTAACGTGT
ATCTTCCGCTT -> TCTTCCGCTTG
ATCTTTGGTAT -> TCTTTGGTATT
ATGAAAACGGT -> TGAAAACGGTA
ATGAAATCATA -> TGAAATCATAG
ATGAAATGGGG -> TGAAATGGGGA
ATGAAGGGTCG -> TGAAGGGTCGG
ATGACGATGTG -> TGACGATGTGT
ATGAGTACTAT -> TGAGTACTATG
ATGATAACGGA -> TGATAACGGAC
ATGCAGCTACC -> TGCAGCTACCA
ATGCCAAGTGG -> TGCCAAGTGGG
ATGCCACAAGG -> TGCCACAAGGT
ATGCCCCGAGC -> TGCCCCGAGCC
ATGCCCTTAAG -> TGCCCTTAAGT
ATGCCTGCGAC -> TGCCTGCGACT
ATGCCTTGCCG -> TGCCTTGCCGA
ATGCGTCGCGG -> TGCGTCGCGGA
ATGCTCGTAAT -> TGCTCGTAATA
ATGCTGGCGGG -> TGCTGGCGGGG
ATGCTTTGAGT -> TGCTTTGAGTC
ATGGCGTATTT -> TGGCGTATTTT
ATGGGATTAGT -> TGGGATTAGTA
ATGGGGACCTC -> TGGGGACCTCT
ATGGGGAGCTA -> TGGGGAGCTAT
ATGGGGTATTG -> TGGGGTATTGA
ATGGGTATTCC -> TGGGTATTCCC
ATGGTACCACT -> TGGTACCACTG
ATGGTACTGGG -> TGGTACTGGGT
ATGGTATGGTA -> TGGTATGGTAC
ATGGTCCTTTC -> TGGTCCTTTCT
ATGTACTCTCG -> TGTACTCTCGG
ATGTCCCCGCA -> TGTCCCCGCAA
ATGTGTTACGA -> TGTGTTACGAT
ATGTTCCCCGA -> TGTTCCCCGAT
ATTACCGTGAA -> TTACCGTGAAG
ATTACGCGGCA -> TTACGCGGCAT
ATTAGGTAAAC -> TTAGGTAAACC
ATTAGTAAACT -> TTAGTAAACTC
ATTAGTGAATA -> TTAGTGAATAG
ATTCATAGACT -> TTCATAGACTC
ATTCCACGGAG -> TTCCACGGAGC
ATTCCCGGTTA -> TTCCCGGTTAC
ATTCCGTCCGA -> TTCCGTCCGAC
ATTCCTCGCCG -> TTCCTCGCCGT
ATTCGACTGAG -> TTCGACTGAGT
ATTCTCATTGC -> TTCTCATTGCC
ATTCTCTTGGC -> TTCTCTTGGCC
ATTGAAGGGTA -> TTGAAGGGTAC
ATTGACGTGAA -> TTGACGTGAAT
ATTGAGAAATC -> TTGAGAAATCG
ATTGCAACCAT -> TTGCAACCATG
ATTGCCGGGTC -> TTGCCGGGTCG
ATTGGCTCAGT -> TTGGCTCAGTC
ATTGTCTGGGA -> TTGTCTGGGAT
ATTTGCCCCGA -> TTTGCCCCGAT
ATTTTAGTGTT -> TTTTAGTGTTG
CAAAACCCACT -> AAAACCCACTG
CAAAATGGTAT -> AAAATGGTATG
CAAACACTTCG -> AAACACTTCGC
CAAACCGGTAT -> AAACCGGTATG
CAACAACCAAA -> AACAACCAAAA
CAACCAAAATG -> AACCAAAATGG
CAACCATGCCT -> AACCATGCCTT
CAACCTCGCTT -> AACCTCGCTTT
CAACGAACCAA -> AACGAACCAAT
CAAGCAATGAA -> AAGCAATGAAA
CAAGCTAATTG -> AAGCTAATTGT
CAAGCTTAGAG -> AAGCTTAGAGA
CAAGGAAGGGA -> AAGGAAGGGAT
CAAGGGATGAA -> AAGGGATGAAA
CAAGGTGCTCC -> AAGGTGCTCCA
CAAGTGGGCGA -> AAGTGGGCGAT
CAATCCTTGCC -> AATCCTTGCCT
CAATCGGCACT -> AATCGGCACTG
CAATCGTCCCA -> AATCGTCCCAA
CAATCTTTGGT -> AATCTTTGGTA
CAATGAAATCA -> AATGAAATCAT
CAATTACCGTG -> AATTACCGTGA
CAATTCCACGG -> AATTCCACGGA
CACAACAACCA -> ACAACAACCAA
CACAAGGTGCT -> ACAAGGTGCTC
CACAGATGCGT -> ACAGATGCGTC
CACAGCATGGC -> ACAGCATGGCG
CACATCTTAAC -> ACATCTTAACG
CACCCGCCACC -> ACCCGCCACCG
CACCGCAGACG -> ACCGCAGACGC
CACCTAAGACT -> ACCTAAGACTC
CACCTCAAAAC -> ACCTCAAAACC
CACGAGTTGAT -> ACGAGTTGATT
CACGGAGCATA -> ACGGAGCATAT
CACGGCCGCGC -> ACGGCCGCGCT
CACGGGCTGGT -> ACGGGCTGGTA
CACGTAGGAGG -> ACGTAGGAGGA
CACGTCCATAT -> ACGTCCATATG
CACGTGTCTAC -> ACGTGTCTACT
CACGTTATCCC -> ACGTTATCCCA
CACTAGTCAAG -> ACTAGTCAAGC
CACTCACTAGT -> ACTCACTAGTC
CACTGAGGAGT -> ACTGAGGAGTC
CACTGCGTGCA -> ACTGCGTGCAC
CACTGGATCGA -> ACTGGATCGAC
CACTGGTCGGT -> ACTGGTCGGTT
CACTGTCTACG -> ACTGTCTACGT
CACTTAAAACC -> ACTTAAAACCC
CACTTCGCAGC -> ACTTCGCAGCG
CAGACGCTGAC -> AGACGCTGACG
CAGAGAACTCG -> AGAGAACTCGA
CAGATACGAAG -> AGATACGAAGT
CAGATCGGTGA -> AGATCGGTGAG
CAGATGCGTCG -> AGATGCGTCGC
CAGCATGGCGT -> AGCATGGCGTA
CAGCGAGGGCC -> AGCGAGGGCCA
CAGCGTGAAAA -> AGCGTGAAAAG
CAGCTACCACG -> AGCTACCACGT
CAGGAGTTGAC -> AGGAGTTGACA
CAGGATTTGCC -> AGGATTTGCCC
CAGGGAATTGA -> AGGGAATTGAG
CAGGGAGTTCG -> AGGGAGTTCGT
CAGTAATACAG -> AGTAATACAGA
CAGTCAATCGG -> AGTCAATCGGC
CAGTCTACTCG -> AGTCTACTCGA
CAGTGCGGTAC -> AGTGCGGTACC
CAGTTAGAGTC -> AGTTAGAGTCA
CAGTTTCTCCG -> AGTTTCTCCGC
CATACTTAAGT -> ATACTTAAGTT
CATAGACTCAG -> ATAGACTCAGG
CATAGTGGCAG -> ATAGTGGCAGA
CATATCAAGGG -> ATATCAAGGGA
CATATGCTGGC -> ATATGCTGGCG
CATCTTAACGT -> ATCTTAACGTG
CATGAGTACTA -> ATGAGTACTAT
CATGCCCTTAA -> ATGCCCTTAAG
CATGCCTTGCC -> ATGCCTTGCCG
CATGCTCGTAA -> ATGCTCGTAAT
CATGGCGTATT -> ATGGCGTATTT
CATTCCGTCCG -> ATTCCGTCCGA
CATTCGACTGA -> ATTCGACTGAG
CATTGAAGGGT -> ATTGAAGGGTA
CATTGCAACCA -> ATTGCAACCAT
CATTGCCGGGT -> ATTGCCGGGTC
CCAAAATGGTA -> CAAAATGGTAT
CCAAACCGGTA -> CAAACCGGTAT
CCAACCTCGCT -> CAACCTCGCTT
CCAAGCAATGA -> CAAGCAATGAA
CCAAGGAAGGG -> CAAGGAAGGGA
CCAAGTGGGCG -> CAAGTGGGCGA
CCAATCCTTGC -> CAATCCTTGCC
CCAATCGTCCC -> CAATCGTCCCA
CCAATTCCACG -> CAATTCCACGG
CCACAAGGTGC -> CACAAGGTGCT
CCACCGCAGAC -> CACCGCAGACG
CCACGAGTTGA -> CACGAGTTGAT
CCACGGAGCAT -> CACGGAGCATA
CCACGGGCTGG -> CACGGGCTGGT
CCACGTAGGAG -> CACGTAGGAGG
CCACGTTATCC -> CACGTTATCCC
CCACTCACTAG -> CACTCACTAGT
CCACTGAGGAG -> CACTGAGGAGT
CCACTGCGTGC -> CACTGCGTGCA
CCACTGGTCGG -> CACTGGTCGGT
CCAGCGAGGGC -> CAGCGAGGGCC
CCAGTCAATCG -> CAGTCAATCGG
CCAGTTAGAGT -> CAGTTAGAGTC
CCATATGCTGG -> CATATGCTGGC
CCATGAGTACT -> CATGAGTACTA
CCATGCCTTGC -> CATGCCTTGCC
CCATTCGACTG -> CATTCGACTGA
CCCAATTCCAC -> CCAATTCCACG
CCCACGAGTTG -> CCACGAGTTGA
CCCACTGGTCG -> CCACTGGTCGG
CCCAGTCAATC -> CCAGTCAATCG
CCCCCGTATAG -> CCCCGTATAGA
CCCCGAGCCAA -> CCCGAGCCAAG
CCCCGATACAC -> CCCGATACACT
CCCCGATGAAG -> CCCGATGAAGG
CCCCGCAACGA -> CCCGCAACGAA
CCCCGCCTAAG -> CCCGCCTAAGT
CCCCGTATAGA -> CCCGTATAGAA
CCCGAGCCAAG -> CCGAGCCAAGC
CCCGATACACT -> CCGATACACTT
CCCGATGAAGG -> CCGATGAAGGG
CCCGCAACGAA -> CCGCAACGAAC
CCCGCCACCGC -> CCGCCACCGCA
CCCGCCTAAGT -> CCGCCTAAGTT
CCCGGTTACGG -> CCGGTTACGGA
CCCGTATAGAA -> CCGTATAGAAT
CCCTAGCACCT -> CCTAGCACCTC
CCCTGGGATCT -> CCTGGGATCTC
CCCTTAAGTCA -> CCTTAAGTCAT
CCCTTGGAGTT -> CCTTGGAGTTG
CCCTTTCGCAT -> CCTTTCGCATA
CCGAAGAAGAC -> CGAAGAAGACT
CCGACCACTCA -> CGACCACTCAC
CCGAGCCAAGC -> CGAGCCAAGCA
CCGAGTAGGCG -> CGAGTAGGCGT
CCGATACACTT -> CGATACACTTA
CCGATGAAGGG -> CGATGAAGGGT
CCGCAACGAAC -> CGCAACGAACC
CCGCAATTACC -> CGCAATTACCG
CCGCACCCGCC -> CGCACCCGCCA
CCGCAGACGCT -> CGCAGACGCTG
CCGCCACCGCA -> CGCCACCGCAG
CCGCCTAAGTT -> CGCCTAAGTTT
CCGCGCGCTGC -> CGCGCGCTGCT
CCGCGCTCCTC -> CGCGCTCCTCG
CCGCTCCCTTT -> CGCTCCCTTTC
CCGCTTGCCGG -> CGCTTGCCGGC
CCGGCCTCGTA -> CGGCCTCGTAT
CCGGCTAACGA -> CGGCTAACGAC
CCGGGTCGACG -> CGGGTCGACGT
CCGGTATGCAG -> CGGTATGCAGC
CCGGTTACGGA -> CGGTTACGGAA
CCGTACTCTGA -> CGTACTCTGAC
CCGTATAGAAT -> CGTATAGAATA
CCGTCCGACCA -> CGTCCGACCAC
CCGTGAAGGGT -> CGTGAAGGGTA
CCTAAGACTCG -> CTAAGACTCGT
CCTAAGGTAAC -> CTAAGGTAACA
CCTAAGTTTCG -> CTAAGTTTCGC
CCTAGCACCTC -> CTAGCACCTCA
CCTCAAAACCC -> CTCAAAACCCA
CCTCGACGGTA -> CTCGACGGTAA
CCTCGCCAGTT -> CTCGCCAGTTA
CCTCGCCGTAC -> CTCGCCGTACT
CCTCGCTGAGG -> CTCGCTGAGGT
CCTCGCTTTTA -> CTCGCTTTTAT
CCTCGTATGCT -> CTCGTATGCTT
CCTCTCTCATT -> CTCTCTCATTG
CCTCTTCCTTG -> CTCTTCCTTGT
CCTGATAGCCA -> CTGATAGCCAG
CCTGCACAGCA -> CTGCACAGCAT
CCTGCAGTTTC -> CTGCAGTTTCT
CCTGCCAATCG -> CTGCCAATCGT
CCTGCGACTTT -> CTGCGACTTTC
CCTGGAAGTTG -> CTGGAAGTTGA
CCTGGGATCTC -> CTGGGATCTCT
CCTTAAGTCAT -> CTTAAGTCATT
CCTTGACAGTA -> CTTGACAGTAA
CCTTGCCGAGT -> CTTGCCGAGTA
CCTTGCCTGCA -> CTTGCCTGCAG
CCTTGGAGTTG -> CTTGGAGTTGA
CCTTGGTGTGC -> CTTGGTGTGCC
CCTTGTTGGGG -> CTTGTTGGGGA
CCTTTCGCATA -> CTTTCGCATAC
CCTTTCTAACG -> CTTTCTAACGT
CGAACCAATCC -> GAACCAATCCT
CGAAGAAGACT -> GAAGAAGACTT
CGAAGTGGCGG -> GAAGTGGCGGT
CGAATGCCAAG -> GAATGCCAAGT
CGAATTCTCAT -> GAATTCTCATT
CGACAAGCTTA -> GACAAGCTTAG
CGACCACTCAC -> GACCACTCACT
CGACCGCACCC -> GACCGCACCCG
CGACGAATTCT -> GACGAATTCTC
CGACGATCTAT -> GACGATCTATT
CGACGGTAACT -> GACGGTAACTC
CGACGTTTTAC -> GACGTTTTACG
CGACTAGTAGA -> GACTAGTAGAC
CGACTGAGTTT -> GACTGAGTTTA
CGACTTTCTTT -> GACTTTCTTTA
CGAGAGGCGTA -> GAGAGGCGTAT
CGAGCCAAGCA -> GAGCCAAGCAA
CGAGGGCCAAA -> GAGGGCCAAAC
CGAGTAGGCGT -> GAGTAGGCGTT
CGAGTGAGTAC -> GAGTGAGTACT
CGAGTTGATTG -> GAGTTGATTGG
CGATACACTTA -> GATACACTTAA
CGATCCACGTT -> GATCCACGTTA
CGATCTATTCC -> GATCTATTCCT
CGATGAAATGG -> GATGAAATGGG
CGATGAAGGGT -> GATGAAGGGTC
CGATGATAACG -> GATGATAACGG
CGATGTGTTAC -> GATGTGTTACG
CGATGTTCCCC -> GATGTTCCCCG
CGCAACGAACC -> GCAACGAACCA
CGCAATTACCG -> GCAATTACCGT
CGCACCCGCCA -> GCACCCGCCAC
CGCAGACGCTG -> GCAGACGCTGA
CGCAGCGTGAA -> GCAGCGTGAAA
CGCAGTGCGGT -> GCAGTGCGGTA
CGCATACTTAA -> GCATACTTAAG
CGCCACCGCAG -> GCCACCGCAGA
CGCCAGTTAGA -> GCCAGTTAGAG
CGCCCCGCCTA -> GCCCCGCCTAA
CGCCGTACTCT -> GCCGTACTCTG
CGCCTAAGTTT -> GCCTAAGTTTC
CGCGACAAGCT -> GCGACAAGCTT
CGCGCGCTGCT -> GCGCGCTGCTG
CGCGCTCCTCG -> GCGCTCCTCGA
CGCGCTGCTGT -> GCGCTGCTGTC
CGCGGAACTGC -> GCGGAACTGCT
CGCGGATGGGG -> GCGGATGGGGA
CGCGGCATGCC -> GCGGCATGCCC
CGCGTGCTGCA -> GCGTGCTGCAG
CGCTCCCTTTC -> GCTCCCTTTCG
CGCTCCTCGAC -> GCTCCTCGACG
CGCTGACGGCG -> GCTGACGGCGA
CGCTGAGGTGG -> GCTGAGGTGGG
CGCTGCTGTCT -> GCTGCTGTCTT
CGCTTGAACTG -> GCTTGAACTGT
CGCTTGCCGGC -> GCTTGCCGGCC
CGCTTTTATGT -> GCTTTTATGTC
CGGAACTGCTA -> GGAACTGCTAA
CGGAACTTTTT -> GGAACTTTTTT
CGGAAGCGGCG -> GGAAGCGGCGT
CGGACAGGATT -> GGACAGGATTT
CGGACCCAGTC -> GGACCCAGTCA
CGGACGACGAA -> GGACGACGAAT
CGGACTAGAAG -> GGACTAGAAGG
CGGACTTGCGT -> GGACTTGCGTC
CGGAGCATATC -> GGAGCATATCA
CGGATGGGGAC -> GGATGGGGACC
CGGCACTGTCT -> GGCACTGTCTA
CGGCATGCCCT -> GGCATGCCCTT
CGGCCGCGCTC -> GGCCGCGCTCC
CGGCCTCGTAT -> GGCCTCGTATG
CGGCGAATGCC -> GGCGAATGCCA
CGGCGTTGCAC -> GGCGTTGCACA
CGGCTAACGAC -> GGCTAACGACT
CGGGCTGGTAT -> GGGCTGGTATA
CGGGGATGCCA -> GGGGATGCCAC
CGGGTCGACGT -> GGGTCGACGTT
CGGGTCGTTAG -> GGGTCGTTAGT
CGGTAAACGAC -> GGTAAACGACG
CGGTAACTCCC -> GGTAACTCCCT
CGGTACCATTC -> GGTACCATTCG
CGGTACTACCC -> GGTACTACCCT
CGGTACTATTC -> GGTACTATTCA
CGGTATGCAGC -> GGTATGCAGCT
CGGTCGATGAT -> GGTCGATGATA
CGGTGAGTTGA -> GGTGAGTTGAA
CGGTTACGGAA -> GGTTACGGAAC
CGGTTATTAGT -> GGTTATTAGTG
CGTAATATGCC -> GTAATATGCCT
CGTACCATGAG -> GTACCATGAGT
CGTACTCTGAC -> GTACTCTGACT
CGTAGGAGGAG -> GTAGGAGGAGT
CGTATACCGCG -> GTATACCGCGC
CGTATAGAATA -> GTATAGAATAT
CGTATAGGCTA -> GTATAGGCTAT
CGTATGCTTTG -> GTATGCTTTGA
CGTATGGGGTA -> GTATGGGGTAT
CGTATTTTAGT -> GTATTTTAGTG
CGTCCATATGC -> GTCCATATGCT
CGTCCCAATTC -> GTCCCAATTCC
CGTCCGACCAC -> GTCCGACCACT
CGTCGAGTGAG -> GTCGAGTGAGT
CGTCGCGGATG -> GTCGCGGATGG
CGTGAAAAGAC -> GTGAAAAGACA
CGTGAACACAG -> GTGAACACAGA
CGTGAAGGGTA -> GTGAAGGGTAA
CGTGAATGGTA -> GTGAATGGTAC
CGTGACGGACT -> GTGACGGACTA
CGTGCACTGGA -> GTGCACTGGAT
CGTGCTGCAGA -> GTGCTGCAGAT
CGTGTCTACTT -> GTGTCTACTTA
CGTGTGCGTAC -> GTGTGCGTACC
CGTTAGTGCTC -> GTTAGTGCTCA
CGTTATCCCAC -> GTTATCCCACG
CGTTCGCGACA -> GTTCGCGACAA
CGTTGCACAAC -> GTTGCACAACA
CGTTGGTATAC -> GTTGGTATACT
CGTTTTACGCG -> GTTTTACGCGT
CTAACGACTAG -> TAACGACTAGT
CTAACGGACGA -> TAACGGACGAC
CTAACGTATAC -> TAACGTATACC
CTAAGACTCGT -> TAAGACTCGTA
CTAAGGTAACA -> TAAGGTAACAC
CTAAGTTTCGC -> TAAGTTTCGCG
CTAATCTTCCG -> TAATCTTCCGC
CTAATTGTCTG -> TAATTGTCTGG
CTACCACGTAG -> TACCACGTAGG
CTACCCTTGGA -> TACCCTTGGAG
CTACGTTGGTA -> TACGTTGGTAT
CTACTCGATGA -> TACTCGATGAA
CTACTTATAGC -> TACTTATAGCC
CTACTTCCACG -> TACTTCCACGG
CTAGAAGGACT -> TAGAAGGACTC
CTAGCACCTCA -> TAGCACCTCAA
CTAGTAGACAC -> TAGTAGACACG
CTAGTCAAGCT -> TAGTCAAGCTA
CTATATTAGGT -> TATATTAGGTA
CTATGACGATG -> TATGACGATGT
CTATGCCCCGA -> TATGCCCCGAG
CTATGTACTCT -> TATGTACTCTC
CTATTCATAGA -> TATTCATAGAC
CTATTCCTCGC -> TATTCCTCGCC
CTCAAAACCCA -> TCAAAACCCAC
CTCACCTAAGA -> TCACCTAAGAC
CTCACTAGTCA -> TCACTAGTCAA
CTCAGGAGTTG -> TCAGGAGTTGA
CTCAGTCTACT -> TCAGTCTACTC
CTCATTCCGTC -> TCATTCCGTCC
CTCATTGCAAC -> TCATTGCAACC
CTCATTGCCGG -> TCATTGCCGGG
CTCCAAGGAAG -> TCCAAGGAAGG
CTCCCTGGGAT -> TCCCTGGGATC
CTCCCTTTCGC -> TCCCTTTCGCA
CTCCGCTCCCT -> TCCGCTCCCTT
CTCCTCGACGG -> TCCTCGACGGT
CTCCTGCACAG -> TCCTGCACAGC
CTCGACGGTAA -> TCGACGGTAAC
CTCGAGAGGCG -> TCGAGAGGCGT
CTCGATGAAAT -> TCGATGAAATG
CTCGCCAGTTA -> TCGCCAGTTAG
CTCGCCCCGCC -> TCGCCCCGCCT
CTCGCCGTACT -> TCGCCGTACTC
CTCGCTGAGGT -> TCGCTGAGGTG
CTCGCTTTTAT -> TCGCTTTTATG
CTCGGACCCAG -> TCGGACCCAGT
CTCGTAATATG -> TCGTAATATGC
CTCGTATAGGC -> TCGTATAGGCT
CTCGTATGCTT -> TCGTATGCTTT
CTCTCATTGCA -> TCTCATTGCAA
CTCTCGGACCC -> TCTCGGACCCA
CTCTCTCATTG -> TCTCTCATTGC
CTCTGACTAAC -> TCTGACTAACG
CTCTGGCCTCG -> TCTGGCCTCGC
CTCTTCCTTGT -> TCTTCCTTGTT
CTCTTGGCCAC -> TCTTGGCCACT
CTGACGGCGAA -> TGACGGCGAAT
CTGACTAACGG -> TGACTAACGGA
CTGAGGAGTCG -> TGAGGAGTCGT
CTGAGGTGGGG -> TGAGGTGGGGT
CTGAGTTTAAC -> TGAGTTTAACA
CTGATAGCCAG -> TGATAGCCAGC
CTGCACAGCAT -> TGCACAGCATG
CTGCAGATCGG -> TGCAGATCGGT
CTGCAGTTTCT -> TGCAGTTTCTC
CTGCCAATCGT -> TGCCAATCGTC
CTGCGACTTTC -> TGCGACTTTCT
CTGCGCAGTGC -> TGCGCAGTGCG
CTGCGTGCACT -> TGCGTGCACTG
CTGCTAATCTT -> TGCTAATCTTC
CTGCTACTTCC -> TGCTACTTCCA
CTGCTGTCTTT -> TGCTGTCTTTG
CTGGAAGTTGA -> TGGAAGTTGAG
CTGGATCGACC -> TGGATCGACCG
CTGGCCTCGCC -> TGGCCTCGCCA
CTGGCGGGGAT -> TGGCGGGGATG
CTGGGATCTCT -> TGGGATCTCTG
CTGGGATGGGA -> TGGGATGGGAT
CTGGGTCTGCG -> TGGGTCTGCGC
CTGGTATATAT -> TGGTATATATC
CTGGTCGGTTA -> TGGTCGGTTAT
CTGTCTACGTT -> TGTCTACGTTG
CTGTCTTTGTA -> TGTCTTTGTAG
CTGTTCGATGG -> TGTTCGATGGA
CTTAAAACCCT -> TTAAAACCCTA
CTTAACGTGTG -> TTAACGTGTGC
CTTAAGTCATT -> TTAAGTCATTG
CTTAAGTTAAA -> TTAAGTTAAAG
CTTAGAGAAAT -> TTAGAGAAATC
CTTATAGCCAA -> TTATAGCCAAC
CTTCCACGGGC -> TTCCACGGGCT
CTTCCGCTTGC -> TTCCGCTTGCC
CTTCCTTGTTG -> TTCCTTGTTGG
CTTCGCAGCGT -> TTCGCAGCGTG
CTTGAACTGTT -> TTGAACTGTTC
CTTGACAGTAA -> TTGACAGTAAT
CTTGCCGAGTA -> TTGCCGAGTAG
CTTGCCGCAAT -> TTGCCGCAATT
CTTGCCGGCCT -> TTGCCGGCCTC
CTTGCCTGCAG -> TTGCCTGCAGT
CTTGCGTCGAG -> TTGCGTCGAGT
CTTGGAGTTGA -> TTGGAGTTGAA
CTTGGCCACTG -> TTGGCCACTGC
CTTGGTGTGCC -> TTGGTGTGCCT
CTTGTTGGGGA -> TTGTTGGGGAT
CTTTACGCTTG -> TTTACGCTTGA
CTTTCGCATAC -> TTTCGCATACT
CTTTCTAACGT -> TTTCTAACGTA
CTTTCTTTACG -> TTTCTTTACGC
CTTTGAGTCAG -> TTTGAGTCAGG
CTTTGGTATTC -> TTTGGTATTCT
CTTTGTAGTAC -> TTTGTAGTACG
CTTTTATGTCC -> TTTTATGTCCC
CTTTTTTCCTG -> TTTTTTCCTGG
GAAAACGGTAA -> AAAACGGTAAA
GAAAAGACATG -> AAAAGACATGC
GAAACCGAAGA -> AAACCGAAGAA
GAAACCGGCTA -> AAACCGGCTAA
GAAATCACGTC -> AAATCACGTCC
GAAATCATAGT -> AAATCATAGTG
GAAATCGGACA -> AAATCGGACAG
GAAATGGGGAG -> AAATGGGGAGC
GAACACAGATG -> AACACAGATGC
GAACCAATCCT -> AACCAATCCTT
GAACTCGAGAG -> AACTCGAGAGG
GAACTGCTAAT -> AACTGCTAATC
GAACTGTTCGA -> AACTGTTCGAT
GAACTTTTTTC -> AACTTTTTTCC
GAAGAAGACTT -> AAGAAGACTTG
GAAGACTTGCC -> AAGACTTGCCG
GAAGCGGCGTT -> AAGCGGCGTTG
GAAGGACTCGC -> AAGGACTCGCC
GAAGGGATGGT -> AAGGGATGGTC
GAAGGGTAAGT -> AAGGGTAAGTG
GAAGGGTACCT -> AAGGGTACCTT
GAAGGGTCGGG -> AAGGGTCGGGT
GAAGTGGCGGT -> AAGTGGCGGTA
GAAGTTGAGCC -> AAGTTGAGCCT
GAATAGATTAC -> AATAGATTACG
GAATATGGGTA -> AATATGGGTAT
GAATGCCAAGT -> AATGCCAAGTG
GAATGGTACTG -> AATGGTACTGG
GAATTCTCATT -> AATTCTCATTG
GAATTGAGAAA -> AATTGAGAAAT
GACAAGCTTAG -> ACAAGCTTAGA
GACACGGCCGC -> ACACGGCCGCG
GACACGTGTCT -> ACACGTGTCTA
GACAGGATTTG -> ACAGGATTTGC
GACAGTAATAC -> ACAGTAATACA
GACATGCTCGT -> ACATGCTCGTA
GACCACTCACT -> ACCACTCACTA
GACCCAGTCAA -> ACCCAGTCAAT
GACCGCACCCG -> ACCGCACCCGC
GACCTCTTCCT -> ACCTCTTCCTT
GACGAATTCTC -> ACGAATTCTCA
GACGACGAATT -> ACGACGAATTC
GACGATCTATT -> ACGATCTATTC
GACGATGTGTT -> ACGATGTGTTA
GACGCTGACGG -> ACGCTGACGGC
GACGGACTAGA -> ACGGACTAGAA
GACGGCGAATG -> ACGGCGAATGC
GACGGTAACTC -> ACGGTAACTCC
GACGTGAATGG -> ACGTGAATGGT
GACGTTTTACG -> ACGTTTTACGC
GACTAACGGAC -> ACTAACGGACG
GACTAGAAGGA -> ACTAGAAGGAC
GACTAGTAGAC -> ACTAGTAGACA
GACTCAGGAGT -> ACTCAGGAGTT
GACTCGCCCCG -> ACTCGCCCCGC
GACTCGTATAG -> ACTCGTATAGG
GACTGAGTTTA -> ACTGAGTTTAA
GACTTGCCGCA -> ACTTGCCGCAA
GACTTGCGTCG -> ACTTGCGTCGA
GACTTTCTTTA -> ACTTTCTTTAC
GAGAAATCACG -> AGAAATCACGT
GAGAAATCGGA -> AGAAATCGGAC
GAGAACTCGAG -> AGAACTCGAGA
GAGAGGCGTAT -> AGAGGCGTATG
GAGCATATCAA -> AGCATATCAAG
GAGCCAAGCAA -> AGCCAAGCAAT
GAGCCTCTCTC -> AGCCTCTCTCA
GAGCTATATTA -> AGCTATATTAG
GAGGAGTCCTG -> AGGAGTCCTGC
GAGGAGTCGTG -> AGGAGTCGTGA
GAGGCGTATGG -> AGGCGTATGGG
GAGGGCCAAAC -> AGGGCCAAACC
GAGGTGGGGTT -> AGGTGGGGTTA
GAGTACTATGA -> AGTACTATGAC
GAGTACTATGC -> AGTACTATGCC
GAGTAGGCGTT -> AGTAGGCGTTC
GAGTCAGGGAA -> AGTCAGGGAAT
GAGTCAGGGAG -> AGTCAGGGAGT
GAGTCCTGCCA -> AGTCCTGCCAA
GAGTCGTGACG -> AGTCGTGACGG
GAGTGAGTACT -> AGTGAGTACTA
GAGTTCGTGAA -> AGTTCGTGAAC
GAGTTGAAACC -> AGTTGAAACCG
GAGTTGACACG -> AGTTGACACGG
GAGTTGATTGG -> AGTTGATTGGC
GAGTTTAACAA -> AGTTTAACAAT
GATAACGGACT -> ATAACGGACTT
GATACACTTAA -> ATACACTTAAA
GATACGAAGTG -> ATACGAAGTGG
GATAGCCAGCG -> ATAGCCAGCGA
GATCCACGTTA -> ATCCACGTTAT
GATCCCCCGTA -> ATCCCCCGTAT
GATCGACCGCA -> ATCGACCGCAC
GATCGGTGAGT -> ATCGGTGAGTT
GATCTATTCCT -> ATCTATTCCTC
GATCTCTGGCC -> ATCTCTGGCCT
GATGAAAACGG -> ATGAAAACGGT
GATGAAATGGG -> ATGAAATGGGG
GATGAAGGGTC -> ATGAAGGGTCG
GATGATAACGG -> ATGATAACGGA
GATGCCACAAG -> ATGCCACAAGG
GATGCGTCGCG -> ATGCGTCGCGG
GATGGGATTAG -> ATGGGATTAGT
GATGGGGACCT -> ATGGGGACCTC
GATGGTCCTTT -> ATGGTCCTTTC
GATGTGTTACG -> ATGTGTTACGA
GATGTTCCCCG -> ATGTTCCCCGA
GATTACGCGGC -> ATTACGCGGCA
GATTAGTAAAC -> ATTAGTAAACT
GATTGGCTCAG -> ATTGGCTCAGT
GATTTGCCCCG -> ATTTGCCCCGA
GCAACCATGCC -> CAACCATGCCT
GCAACGAACCA -> CAACGAACCAA
GCAATGAAATC -> CAATGAAATCA
GCAATTACCGT -> CAATTACCGTG
GCACAACAACC -> CACAACAACCA
GCACAGCATGG -> CACAGCATGGC
GCACCCGCCAC -> CACCCGCCACC
GCACCTCAAAA -> CACCTCAAAAC
GCACTGGATCG -> CACTGGATCGA
GCACTGTCTAC -> CACTGTCTACG
GCAGACGCTGA -> CAGACGCTGAC
GCAGATACGAA -> CAGATACGAAG
GCAGATCGGTG -> CAGATCGGTGA
GCAGCGTGAAA -> CAGCGTGAAAA
GCAGCTACCAC -> CAGCTACCACG
GCAGTGCGGTA -> CAGTGCGGTAC
GCAGTTTCTCC -> CAGTTTCTCCG
GCATACTTAAG -> CATACTTAAGT
GCATATCAAGG -> CATATCAAGGG
GCATGCCCTTA -> CATGCCCTTAA
GCATGGCGTAT -> CATGGCGTATT
GCCAAACCGGT -> CCAAACCGGTA
GCCAACCTCGC -> CCAACCTCGCT
GCCAAGCAATG -> CCAAGCAATGA
GCCAAGTGGGC -> CCAAGTGGGCG
GCCAATCGTCC -> CCAATCGTCCC
GCCACAAGGTG -> CCACAAGGTGC
GCCACCGCAGA -> CCACCGCAGAC
GCCACTGCGTG -> CCACTGCGTGC
GCCAGCGAGGG -> CCAGCGAGGGC
GCCAGTTAGAG -> CCAGTTAGAGT
GCCCCGAGCCA -> CCCCGAGCCAA
GCCCCGATACA -> CCCCGATACAC
GCCCCGCCTAA -> CCCCGCCTAAG
GCCCTTAAGTC -> CCCTTAAGTCA
GCCGAGTAGGC -> CCGAGTAGGCG
GCCGCAATTAC -> CCGCAATTACC
GCCGCGCTCCT -> CCGCGCTCCTC
GCCGGCCTCGT -> CCGGCCTCGTA
GCCGGGTCGAC -> CCGGGTCGACG
GCCGTACTCTG -> CCGTACTCTGA
GCCTAAGTTTC -> CCTAAGTTTCG
GCCTCGCCAGT -> CCTCGCCAGTT
GCCTCGCTGAG -> CCTCGCTGAGG
GCCTCGTATGC -> CCTCGTATGCT
GCCTCTCTCAT -> CCTCTCTCATT
GCCTGCAGTTT -> CCTGCAGTTTC
GCCTGCGACTT -> CCTGCGACTTT
GCCTTGACAGT -> CCTTGACAGTA
GCCTTGCCGAG -> CCTTGCCGAGT
GCGAATGCCAA -> CGAATGCCAAG
GCGACAAGCTT -> CGACAAGCTTA
GCGACTTTCTT -> CGACTTTCTTT
GCGAGGGCCAA -> CGAGGGCCAAA
GCGATCCACGT -> CGATCCACGTT
GCGCAGTGCGG -> CGCAGTGCGGT
GCGCGCTGCTG -> CGCGCTGCTGT
GCGCTCCTCGA -> CGCTCCTCGAC
GCGCTGCTGTC -> CGCTGCTGTCT
GCGGAACTGCT -> CGGAACTGCTA
GCGGATGGGGA -> CGGATGGGGAC
GCGGCATGCCC -> CGGCATGCCCT
GCGGCGTTGCA -> CGGCGTTGCAC
GCGGGGATGCC -> CGGGGATGCCA
GCGGTACCATT -> CGGTACCATTC
GCGGTACTATT -> CGGTACTATTC
GCGTACCATGA -> CGTACCATGAG
GCGTATGGGGT -> CGTATGGGGTA
GCGTATTTTAG -> CGTATTTTAGT
GCGTCGAGTGA -> CGTCGAGTGAG
GCGTCGCGGAT -> CGTCGCGGATG
GCGTGAAAAGA -> CGTGAAAAGAC
GCGTGCACTGG -> CGTGCACTGGA
GCGTGCTGCAG -> CGTGCTGCAGA
GCGTTCGCGAC -> CGTTCGCGACA
GCGTTGCACAA -> CGTTGCACAAC
GCTAACGACTA -> CTAACGACTAG
GCTAATCTTCC -> CTAATCTTCCG
GCTAATTGTCT -> CTAATTGTCTG
GCTACCACGTA -> CTACCACGTAG
GCTACTTCCAC -> CTACTTCCACG
GCTATATTAGG -> CTATATTAGGT
GCTATGTACTC -> CTATGTACTCT
GCTCACCTAAG -> CTCACCTAAGA
GCTCAGTCTAC -> CTCAGTCTACT
GCTCATTCCGT -> CTCATTCCGTC
GCTCCAAGGAA -> CTCCAAGGAAG
GCTCCCTTTCG -> CTCCCTTTCGC
GCTCCTCGACG -> CTCCTCGACGG
GCTCGTAATAT -> CTCGTAATATG
GCTGACGGCGA -> CTGACGGCGAA
GCTGAGGTGGG -> CTGAGGTGGGG
GCTGCAGATCG -> CTGCAGATCGG
GCTGCTGTCTT -> CTGCTGTCTTT
GCTGGCGGGGA -> CTGGCGGGGAT
GCTGGTATATA -> CTGGTATATAT
GCTGTCTTTGT -> CTGTCTTTGTA
GCTTAGAGAAA -> CTTAGAGAAAT
GCTTGAACTGT -> CTTGAACTGTT
GCTTGCCGGCC -> CTTGCCGGCCT
GCTTTGAGTCA -> CTTTGAGTCAG
GCTTTTATGTC -> CTTTTATGTCC
GGAACTGCTAA -> GAACTGCTAAT
GGAACTTTTTT -> GAACTTTTTTC
GGAAGCGGCGT -> GAAGCGGCGTT
GGAAGGGATGG -> GAAGGGATGGT
GGAAGTTGAGC -> GAAGTTGAGCC
GGAATTGAGAA -> GAATTGAGAAA
GGACAGGATTT -> GACAGGATTTG
GGACCCAGTCA -> GACCCAGTCAA
GGACCTCTTCC -> GACCTCTTCCT
GGACGACGAAT -> GACGACGAATT
GGACTAGAAGG -> GACTAGAAGGA
GGACTCGCCCC -> GACTCGCCCCG
GGACTTGCGTC -> GACTTGCGTCG
GGAGCATATCA -> GAGCATATCAA
GGAGCTATATT -> GAGCTATATTA
GGAGGAGTCCT -> GAGGAGTCCTG
GGAGTCCTGCC -> GAGTCCTGCCA
GGAGTCGTGAC -> GAGTCGTGACG
GGAGTTCGTGA -> GAGTTCGTGAA
GGAGTTGAAAC -> GAGTTGAAACC
GGAGTTGACAC -> GAGTTGACACG
GGATCCCCCGT -> GATCCCCCGTA
GGATCGACCGC -> GATCGACCGCA
GGATCTCTGGC -> GATCTCTGGCC
GGATGAAAACG -> GATGAAAACGG
GGATGCCACAA -> GATGCCACAAG
GGATGGGATTA -> GATGGGATTAG
GGATGGGGACC -> GATGGGGACCT
GGATGGTCCTT -> GATGGTCCTTT
GGATTAGTAAA -> GATTAGTAAAC
GGATTTGCCCC -> GATTTGCCCCG
GGCACTGTCTA -> GCACTGTCTAC
GGCAGATACGA -> GCAGATACGAA
GGCATGCCCTT -> GCATGCCCTTA
GGCCAAACCGG -> GCCAAACCGGT
GGCCACTGCGT -> GCCACTGCGTG
GGCCGCGCTCC -> GCCGCGCTCCT
GGCCTCGCCAG -> GCCTCGCCAGT
GGCCTCGTATG -> GCCTCGTATGC
GGCGAATGCCA -> GCGAATGCCAA
GGCGATCCACG -> GCGATCCACGT
GGCGGGGATGC -> GCGGGGATGCC
GGCGGTACTAT -> GCGGTACTATT
GGCGTATGGGG -> GCGTATGGGGT
GGCGTATTTTA -> GCGTATTTTAG
GGCGTTCGCGA -> GCGTTCGCGAC
GGCGTTGCACA -> GCGTTGCACAA
GGCTAACGACT -> GCTAACGACTA
GGCTATGTACT -> GCTATGTACTC
GGCTCACCTAA -> GCTCACCTAAG
GGCTCAGTCTA -> GCTCAGTCTAC
GGCTGGTATAT -> GCTGGTATATA
GGGAATTGAGA -> GGAATTGAGAA
GGGACCTCTTC -> GGACCTCTTCC
GGGAGCTATAT -> GGAGCTATATT
GGGAGTTCGTG -> GGAGTTCGTGA
GGGATCCCCCG -> GGATCCCCCGT
GGGATCTCTGG -> GGATCTCTGGC
GGGATGAAAAC -> GGATGAAAACG
GGGATGCCACA -> GGATGCCACAA
GGGATGGGATT -> GGATGGGATTA
GGGATGGTCCT -> GGATGGTCCTT
GGGATTAGTAA -> GGATTAGTAAA
GGGCCAAACCG -> GGCCAAACCGG
GGGCGATCCAC -> GGCGATCCACG
GGGCTCACCTA -> GGCTCACCTAA
GGGCTGGTATA -> GGCTGGTATAT
GGGGACCTCTT -> GGGACCTCTTC
GGGGAGCTATA -> GGGAGCTATAT
GGGGATCCCCC -> GGGATCCCCCG
GGGGATGCCAC -> GGGATGCCACA
GGGGTATTGAC -> GGGTATTGACG
GGGGTTAGCCT -> GGGTTAGCCTT
GGGTAAGTGTT -> GGTAAGTGTTT
GGGTACCTTGG -> GGTACCTTGGT
GGGTATTCCCG -> GGTATTCCCGG
GGGTATTGACG -> GGTATTGACGT
GGGTCGACGTT -> GGTCGACGTTT
GGGTCGGGTCG -> GGTCGGGTCGT
GGGTCGTTAGT -> GGTCGTTAGTG
GGGTCTGCGCA -> GGTCTGCGCAG
GGGTTAGCCTT -> GGTTAGCCTTG
GGTAAACCTGA -> GTAAACCTGAT
GGTAAACGACG -> GTAAACGACGA
GGTAACACATC -> GTAACACATCT
GGTAACTCCCT -> GTAACTCCCTG
GGTAAGTGTTT -> GTAAGTGTTTC
GGTACCACTGA -> GTACCACTGAG
GGTACCATTCG -> GTACCATTCGA
GGTACCTTGGT -> GTACCTTGGTG
GGTACTACCCT -> GTACTACCCTT
GGTACTATTCA -> GTACTATTCAT
GGTACTGGGTC -> GTACTGGGTCT
GGTATACTGCT -> GTATACTGCTA
GGTATATATCG -> GTATATATCGG
GGTATGCAGCT -> GTATGCAGCTA
GGTATGGTACC -> GTATGGTACCA
GGTATTCCCGG -> GTATTCCCGGT
GGTATTCTCTT -> GTATTCTCTTG
GGTATTGACGT -> GTATTGACGTG
GGTCCTTTCTA -> GTCCTTTCTAA
GGTCGACGTTT -> GTCGACGTTTT
GGTCGATGATA -> GTCGATGATAA
GGTCGGGTCGT -> GTCGGGTCGTT
GGTCGGTTATT -> GTCGGTTATTA
GGTCGTTAGTG -> GTCGTTAGTGC
GGTCTGCGCAG -> GTCTGCGCAGT
GGTGAGTTGAA -> GTGAGTTGAAA
GGTGCTCCAAG -> GTGCTCCAAGG
GGTGGGGTTAG -> GTGGGGTTAGC
GGTGTGCCTCG -> GTGTGCCTCGC
GGTTACGGAAC -> GTTACGGAACT
GGTTAGCCTTG -> GTTAGCCTTGA
GGTTATTAGTG -> GTTATTAGTGA
GTAAACCTGAT -> TAAACCTGATA
GTAAACGACGA -> TAAACGACGAT
GTAAACTCCTG -> TAAACTCCTGC
GTAACACATCT -> TAACACATCTT
GTAACTCCCTG -> TAACTCCCTGG
GTAAGTGTTTC -> TAAGTGTTTCG
GTAATACAGAG -> TAATACAGAGA
GTAATATGCCT -> TAATATGCCTG
GTACCACTGAG -> TACCACTGAGG
GTACCATGAGT -> TACCATGAGTA
GTACCATTCGA -> TACCATTCGAC
GTACCTTGGTG -> TACCTTGGTGT
GTACGGTACTA -> TACGGTACTAC
GTACTACCCTT -> TACTACCCTTG
GTACTATGACG -> TACTATGACGA
GTACTATGCCC -> TACTATGCCCC
GTACTATTCAT -> TACTATTCATA
GTACTCTCGGA -> TACTCTCGGAC
GTACTCTGACT -> TACTCTGACTA
GTACTGGGTCT -> TACTGGGTCTG
GTAGACACGTG -> TAGACACGTGT
GTAGGAGGAGT -> TAGGAGGAGTC
GTAGGCGTTCG -> TAGGCGTTCGC
GTAGTACGGTA -> TAGTACGGTAC
GTATACCGCGC -> TATACCGCGCG
GTATACTGCTA -> TATACTGCTAC
GTATAGAATAT -> TATAGAATATG
GTATAGGCTAT -> TATAGGCTATG
GTATATATCGG -> TATATATCGGA
GTATGCAGCTA -> TATGCAGCTAC
GTATGCTTTGA -> TATGCTTTGAG
GTATGGGGTAT -> TATGGGGTATT
GTATGGTACCA -> TATGGTACCAC
GTATTCCCGGT -> TATTCCCGGTT
GTATTCTCTTG -> TATTCTCTTGG
GTATTGACGTG -> TATTGACGTGA
GTATTTTAGTG -> TATTTTAGTGT
GTCAAACACTT -> TCAAACACTTC
GTCAAGCTAAT -> TCAAGCTAATT
GTCAATCGGCA -> TCAATCGGCAC
GTCAGGGAATT -> TCAGGGAATTG
GTCAGGGAGTT -> TCAGGGAGTTC
GTCATTGAAGG -> TCATTGAAGGG
GTCCATATGCT -> TCCATATGCTG
GTCCCAATTCC -> TCCCAATTCCA
GTCCCCGCAAC -> TCCCCGCAACG
GTCCGACCACT -> TCCGACCACTC
GTCCTGCCAAT -> TCCTGCCAATC
GTCCTTTCTAA -> TCCTTTCTAAC
GTCGACGTTTT -> TCGACGTTTTA
GTCGAGTGAGT -> TCGAGTGAGTA
GTCGATGATAA -> TCGATGATAAC
GTCGCGGATGG -> TCGCGGATGGG
GTCGGGTCGTT -> TCGGGTCGTTA
GTCGGTTATTA -> TCGGTTATTAG
GTCGTGACGGA -> TCGTGACGGAC
GTCGTTAGTGC -> TCGTTAGTGCT
GTCTACGTTGG -> TCTACGTTGGT
GTCTACTCGAT -> TCTACTCGATG
GTCTACTTATA -> TCTACTTATAG
GTCTGCGCAGT -> TCTGCGCAGTG
GTCTGGGATGG -> TCTGGGATGGG
GTCTTTGTAGT -> TCTTTGTAGTA
GTGAAAAGACA -> TGAAAAGACAT
GTGAACACAGA -> TGAACACAGAT
GTGAAGGGTAA -> TGAAGGGTAAG
GTGAATAGATT -> TGAATAGATTA
GTGAATGGTAC -> TGAATGGTACT
GTGACGGACTA -> TGACGGACTAG
GTGAGTACTAT -> TGAGTACTATG
GTGAGTTGAAA -> TGAGTTGAAAC
GTGCACTGGAT -> TGCACTGGATC
GTGCCTCGCTG -> TGCCTCGCTGA
GTGCGGTACCA -> TGCGGTACCAT
GTGCGTACCAT -> TGCGTACCATG
GTGCTCATTCC -> TGCTCATTCCG
GTGCTCCAAGG -> TGCTCCAAGGA
GTGCTGCAGAT -> TGCTGCAGATC
GTGGCAGATAC -> TGGCAGATACG
GTGGCGGTACT -> TGGCGGTACTA
GTGGGCGATCC -> TGGGCGATCCA
GTGGGGTTAGC -> TGGGGTTAGCC
GTGTCTACTTA -> TGTCTACTTAT
GTGTGCCTCGC -> TGTGCCTCGCT
GTGTGCGTACC -> TGTGCGTACCA
GTGTTACGATG -> TGTTACGATGT
GTGTTGGGCTC -> TGTTGGGCTCA
GTGTTTCGGTC -> TGTTTCGGTCG
GTTAAAGTCAA -> TTAAAGTCAAA
GTTACGATGTT -> TTACGATGTTC
GTTACGGAACT -> TTACGGAACTT
GTTAGAGTCAG -> TTAGAGTCAGG
GTTAGCCTTGA -> TTAGCCTTGAC
GTTAGTGCTCA -> TTAGTGCTCAT
GTTATCCCACG -> TTATCCCACGA
GTTATTAGTGA -> TTATTAGTGAA
GTTCCCCGATG -> TTCCCCGATGA
GTTCGATGGAT -> TTCGATGGATT
GTTCGCGACAA -> TTCGCGACAAG
GTTCGTGAACA -> TTCGTGAACAC
GTTGAAACCGA -> TTGAAACCGAA
GTTGAAACCGG -> TTGAAACCGGC
GTTGACACGGC -> TTGACACGGCC
GTTGAGCCTCT -> TTGAGCCTCTC
GTTGATTGGCT -> TTGATTGGCTC
GTTGCACAACA -> TTGCACAACAA
GTTGGGCTCAC -> TTGGGCTCACC
GTTGGGGATCC -> TTGGGGATCCC
GTTGGTATACT -> TTGGTATACTG
GTTTAACAATC -> TTTAACAATCT
GTTTCGCGGAA -> TTTCGCGGAAC
GTTTCGGTCGA -> TTTCGGTCGAT
GTTTCTCCGCT -> TTTCTCCGCTC
GTTTTACGCGT -> TTTTACGCGTG
TAAAACCCTAG -> AAAACCCTAGC
TAAACCTGATA -> AAACCTGATAG
TAAACGACGAT -> AAACGACGATC
TAAACTCCTGC -> AAACTCCTGCA
TAAAGTCAAAC -> AAAGTCAAACA
TAACAATCTTT -> AACAATCTTTG
TAACACATCTT -> AACACATCTTA
TAACGACTAGT -> AACGACTAGTA
TAACGGACGAC -> AACGGACGACG
TAACGGACTTG -> AACGGACTTGC
TAACGTATACC -> AACGTATACCG
TAACGTGTGCG -> AACGTGTGCGT
TAACTCCCTGG -> AACTCCCTGGG
TAAGACTCGTA -> AAGACTCGTAT
TAAGGTAACAC -> AAGGTAACACA
TAAGTCATTGA -> AAGTCATTGAA
TAAGTGTTTCG -> AAGTGTTTCGG
TAAGTTAAAGT -> AAGTTAAAGTC
TAAGTTTCGCG -> AAGTTTCGCGG
TAATACAGAGA -> AATACAGAGAA
TAATATGCCTG -> AATATGCCTGC
TAATCTTCCGC -> AATCTTCCGCT
TAATTGTCTGG -> AATTGTCTGGG
TACACTTAAAA -> ACACTTAAAAC
TACAGAGAACT -> ACAGAGAACTC
TACCACGTAGG -> ACCACGTAGGA
TACCACTGAGG -> ACCACTGAGGA
TACCATGAGTA -> ACCATGAGTAC
TACCATTCGAC -> ACCATTCGACT
TACCCTTGGAG -> ACCCTTGGAGT
TACCGCGCGCT -> ACCGCGCGCTG
TACCGTGAAGG -> ACCGTGAAGGG
TACCTTGGTGT -> ACCTTGGTGTG
TACGAAGTGGC -> ACGAAGTGGCG
TACGATGTTCC -> ACGATGTTCCC
TACGCGGCATG -> ACGCGGCATGC
TACGCGTGCTG -> ACGCGTGCTGC
TACGCTTGAAC -> ACGCTTGAACT
TACGGAACTTT -> ACGGAACTTTT
TACGGTACTAC -> ACGGTACTACC
TACGTTGGTAT -> ACGTTGGTATA
TACTACCCTTG -> ACTACCCTTGG
TACTATGACGA -> ACTATGACGAT
TACTATGCCCC -> ACTATGCCCCG
TACTATTCATA -> ACTATTCATAG
TACTCGATGAA -> ACTCGATGAAA
TACTCTCGGAC -> ACTCTCGGACC
TACTCTGACTA -> ACTCTGACTAA
TACTGCTACTT -> ACTGCTACTTC
TACTGGGTCTG -> ACTGGGTCTGC
TACTTAAGTTA -> ACTTAAGTTAA
TACTTATAGCC -> ACTTATAGCCA
TACTTCCACGG -> ACTTCCACGGG
TAGAAGGACTC -> AGAAGGACTCG
TAGAATATGGG -> AGAATATGGGT
TAGACACGTGT -> AGACACGTGTC
TAGACTCAGGA -> AGACTCAGGAG
TAGAGAAATCA -> AGAGAAATCAC
TAGAGTCAGGG -> AGAGTCAGGGA
TAGATTACGCG -> AGATTACGCGG
TAGCACCTCAA -> AGCACCTCAAA
TAGCCAACCTC -> AGCCAACCTCG
TAGCCAGCGAG -> AGCCAGCGAGG
TAGCCTTGACA -> AGCCTTGACAG
TAGGAGGAGTC -> AGGAGGAGTCC
TAGGCGTTCGC -> AGGCGTTCGCG
TAGGCTATGTA -> AGGCTATGTAC
TAGGTAAACCT -> AGGTAAACCTG
TAGTAAACTCC -> AGTAAACTCCT
TAGTACGGTAC -> AGTACGGTACT
TAGTAGACACG -> AGTAGACACGT
TAGTCAAGCTA -> AGTCAAGCTAA
TAGTGAATAGA -> AGTGAATAGAT
TAGTGCTCATT -> AGTGCTCATTC
TAGTGGCAGAT -> AGTGGCAGATA
TAGTGTTGGGC -> AGTGTTGGGCT
TATACCGCGCG -> ATACCGCGCGC
TATACTGCTAC -> ATACTGCTACT
TATAGAATATG -> ATAGAATATGG
TATAGCCAACC -> ATAGCCAACCT
TATAGGCTATG -> ATAGGCTATGT
TATATATCGGA -> ATATATCGGAA
TATATCGGAAG -> ATATCGGAAGC
TATATTAGGTA -> ATATTAGGTAA
TATCAAGGGAT -> ATCAAGGGATG
TATCCCACGAG -> ATCCCACGAGT
TATCGGAAGCG -> ATCGGAAGCGG
TATGACGATGT -> ATGACGATGTG
TATGCAGCTAC -> ATGCAGCTACC
TATGCCCCGAG -> ATGCCCCGAGC
TATGCCTGCGA -> ATGCCTGCGAC
TATGCTGGCGG -> ATGCTGGCGGG
TATGCTTTGAG -> ATGCTTTGAGT
TATGGGGTATT -> ATGGGGTATTG
TATGGGTATTC -> ATGGGTATTCC
TATGGTACCAC -> ATGGTACCACT
TATGTACTCTC -> ATGTACTCTCG
TATGTCCCCGC -> ATGTCCCCGCA
TATTAGGTAAA -> ATTAGGTAAAC
TATTAGTGAAT -> ATTAGTGAATA
TATTCATAGAC -> ATTCATAGACT
TATTCCCGGTT -> ATTCCCGGTTA
TATTCCTCGCC -> ATTCCTCGCCG
TATTCTCTTGG -> ATTCTCTTGGC
TATTGACGTGA -> ATTGACGTGAA
TATTTTAGTGT -> ATTTTAGTGTT
TCAAAACCCAC -> CAAAACCCACT
TCAAACACTTC -> CAAACACTTCG
TCAAGCTAATT -> CAAGCTAATTG
TCAAGGGATGA -> CAAGGGATGAA
TCAATCGGCAC -> CAATCGGCACT
TCACCTAAGAC -> CACCTAAGACT
TCACGTCCATA -> CACGTCCATAT
TCACTAGTCAA -> CACTAGTCAAG
TCAGGAGTTGA -> CAGGAGTTGAC
TCAGGGAATTG -> CAGGGAATTGA
TCAGGGAGTTC -> CAGGGAGTTCG
TCAGTCTACTC -> CAGTCTACTCG
TCATAGACTCA -> CATAGACTCAG
TCATAGTGGCA -> CATAGTGGCAG
TCATTCCGTCC -> CATTCCGTCCG
TCATTGAAGGG -> CATTGAAGGGT
TCATTGCAACC -> CATTGCAACCA
TCATTGCCGGG -> CATTGCCGGGT
TCCAAGGAAGG -> CCAAGGAAGGG
TCCACGGAGCA -> CCACGGAGCAT
TCCACGGGCTG -> CCACGGGCTGG
TCCACGTTATC -> CCACGTTATCC
TCCATATGCTG -> CCATATGCTGG
TCCCAATTCCA -> CCCAATTCCAC
TCCCACGAGTT -> CCCACGAGTTG
TCCCCCGTATA -> CCCCCGTATAG
TCCCCGATGAA -> CCCCGATGAAG
TCCCCGCAACG -> CCCCGCAACGA
TCCCGGTTACG -> CCCGGTTACGG
TCCCTGGGATC -> CCCTGGGATCT
TCCCTTTCGCA -> CCCTTTCGCAT
TCCGACCACTC -> CCGACCACTCA
TCCGCTCCCTT -> CCGCTCCCTTT
TCCGCTTGCCG -> CCGCTTGCCGG
TCCGTCCGACC -> CCGTCCGACCA
TCCTCGACGGT -> CCTCGACGGTA
TCCTCGCCGTA -> CCTCGCCGTAC
TCCTGCACAGC -> CCTGCACAGCA
TCCTGCCAATC -> CCTGCCAATCG
TCCTGGAAGTT -> CCTGGAAGTTG
TCCTTGCCTGC -> CCTTGCCTGCA
TCCTTGTTGGG -> CCTTGTTGGGG
TCCTTTCTAAC -> CCTTTCTAACG
TCGACCGCACC -> CGACCGCACCC
TCGACGGTAAC -> CGACGGTAACT
TCGACGTTTTA -> CGACGTTTTAC
TCGACTGAGTT -> CGACTGAGTTT
TCGAGAGGCGT -> CGAGAGGCGTA
TCGAGTGAGTA -> CGAGTGAGTAC
TCGATGAAATG -> CGATGAAATGG
TCGATGATAAC -> CGATGATAACG
TCGATGGATTT -> CGATGGATTTA
TCGCAGCGTGA -> CGCAGCGTGAA
TCGCATACTTA -> CGCATACTTAA
TCGCCAGTTAG -> CGCCAGTTAGA
TCGCCCCGCCT -> CGCCCCGCCTA
TCGCCGTACTC -> CGCCGTACTCT
TCGCGACAAGC -> CGCGACAAGCT
TCGCGGAACTG -> CGCGGAACTGC
TCGCGGATGGG -> CGCGGATGGGG
TCGCTGAGGTG -> CGCTGAGGTGG
TCGCTTTTATG -> CGCTTTTATGT
TCGGAAGCGGC -> CGGAAGCGGCG
TCGGACAGGAT -> CGGACAGGATT
TCGGACCCAGT -> CGGACCCAGTC
TCGGCACTGTC -> CGGCACTGTCT
TCGGGTCGTTA -> CGGGTCGTTAG
TCGGTCGATGA -> CGGTCGATGAT
TCGGTGAGTTG -> CGGTGAGTTGA
TCGGTTATTAG -> CGGTTATTAGT
TCGTAATATGC -> CGTAATATGCC
TCGTATAGGCT -> CGTATAGGCTA
TCGTATGCTTT -> CGTATGCTTTG
TCGTCCCAATT -> CGTCCCAATTC
TCGTGAACACA -> CGTGAACACAG
TCGTGACGGAC -> CGTGACGGACT
TCGTTAGTGCT -> CGTTAGTGCTC
TCTAACGTATA -> CTAACGTATAC
TCTACGTTGGT -> CTACGTTGGTA
TCTACTCGATG -> CTACTCGATGA
TCTACTTATAG -> CTACTTATAGC
TCTATTCCTCG -> CTATTCCTCGC
TCTCATTGCAA -> CTCATTGCAAC
TCTCATTGCCG -> CTCATTGCCGG
TCTCCGCTCCC -> CTCCGCTCCCT
TCTCGGACCCA -> CTCGGACCCAG
TCTCTCATTGC -> CTCTCATTGCA
TCTCTGGCCTC -> CTCTGGCCTCG
TCTCTTGGCCA -> CTCTTGGCCAC
TCTGACTAACG -> CTGACTAACGG
TCTGCGCAGTG -> CTGCGCAGTGC
TCTGGCCTCGC -> CTGGCCTCGCC
TCTGGGATGGG -> CTGGGATGGGA
TCTTAACGTGT -> CTTAACGTGTG
TCTTCCGCTTG -> CTTCCGCTTGC
TCTTCCTTGTT -> CTTCCTTGTTG
TCTTGGCCACT -> CTTGGCCACTG
TCTTTACGCTT -> CTTTACGCTTG
TCTTTGGTATT -> CTTTGGTATTC
TCTTTGTAGTA -> CTTTGTAGTAC
TGAAAACGGTA -> GAAAACGGTAA
TGAAAAGACAT -> GAAAAGACATG
TGAAACCGAAG -> GAAACCGAAGA
TGAAACCGGCT -> GAAACCGGCTA
TGAAATCATAG -> GAAATCATAGT
TGAAATGGGGA -> GAAATGGGGAG
TGAACACAGAT -> GAACACAGATG
TGAACTGTTCG -> GAACTGTTCGA
TGAAGGGTAAG -> GAAGGGTAAGT
TGAAGGGTACC -> GAAGGGTACCT
TGAAGGGTCGG -> GAAGGGTCGGG
TGAATAGATTA -> GAATAGATTAC
TGAATGGTACT -> GAATGGTACTG
TGACACGGCCG -> GACACGGCCGC
TGACAGTAATA -> GACAGTAATAC
TGACGATGTGT -> GACGATGTGTT
TGACGGACTAG -> GACGGACTAGA
TGACGGCGAAT -> GACGGCGAATG
TGACGTGAATG -> GACGTGAATGG
TGACTAACGGA -> GACTAACGGAC
TGAGAAATCGG -> GAGAAATCGGA
TGAGCCTCTCT -> GAGCCTCTCTC
TGAGGAGTCGT -> GAGGAGTCGTG
TGAGGTGGGGT -> GAGGTGGGGTT
TGAGTACTATG -> GAGTACTATGA,GAGTACTATGC
TGAGTCAGGGA -> GAGTCAGGGAG
TGAGTTGAAAC -> GAGTTGAAACC
TGAGTTTAACA -> GAGTTTAACAA
TGATAACGGAC -> GATAACGGACT
TGATAGCCAGC -> GATAGCCAGCG
TGATTGGCTCA -> GATTGGCTCAG
TGCAACCATGC -> GCAACCATGCC
TGCACAACAAC -> GCACAACAACC
TGCACAGCATG -> GCACAGCATGG
TGCACTGGATC -> GCACTGGATCG
TGCAGATCGGT -> GCAGATCGGTG
TGCAGCTACCA -> GCAGCTACCAC
TGCAGTTTCTC -> GCAGTTTCTCC
TGCCAAGTGGG -> GCCAAGTGGGC
TGCCAATCGTC -> GCCAATCGTCC
TGCCACAAGGT -> GCCACAAGGTG
TGCCCCGAGCC -> GCCCCGAGCCA
TGCCCCGATAC -> GCCCCGATACA
TGCCCTTAAGT -> GCCCTTAAGTC
TGCCGAGTAGG -> GCCGAGTAGGC
TGCCGCAATTA -> GCCGCAATTAC
TGCCGGCCTCG -> GCCGGCCTCGT
TGCCGGGTCGA -> GCCGGGTCGAC
TGCCTCGCTGA -> GCCTCGCTGAG
TGCCTGCAGTT -> GCCTGCAGTTT
TGCCTGCGACT -> GCCTGCGACTT
TGCCTTGCCGA -> GCCTTGCCGAG
TGCGACTTTCT -> GCGACTTTCTT
TGCGCAGTGCG -> GCGCAGTGCGG
TGCGGTACCAT -> GCGGTACCATT
TGCGTACCATG -> GCGTACCATGA
TGCGTCGAGTG -> GCGTCGAGTGA
TGCGTCGCGGA -> GCGTCGCGGAT
TGCGTGCACTG -> GCGTGCACTGG
TGCTAATCTTC -> GCTAATCTTCC
TGCTACTTCCA -> GCTACTTCCAC
TGCTCATTCCG -> GCTCATTCCGT
TGCTCCAAGGA -> GCTCCAAGGAA
TGCTCGTAATA -> GCTCGTAATAT
TGCTGCAGATC -> GCTGCAGATCG
TGCTGGCGGGG -> GCTGGCGGGGA
TGCTGTCTTTG -> GCTGTCTTTGT
TGCTTTGAGTC -> GCTTTGAGTCA
TGGAAGTTGAG -> GGAAGTTGAGC
TGGAGTTGAAA -> GGAGTTGAAAC
TGGATCGACCG -> GGATCGACCGC
TGGCAGATACG -> GGCAGATACGA
TGGCCACTGCG -> GGCCACTGCGT
TGGCCTCGCCA -> GGCCTCGCCAG
TGGCGGGGATG -> GGCGGGGATGC
TGGCGGTACTA -> GGCGGTACTAT
TGGCGTATTTT -> GGCGTATTTTA
TGGCTCAGTCT -> GGCTCAGTCTA
TGGGATCTCTG -> GGGATCTCTGG
TGGGATGGGAT -> GGGATGGGATT
TGGGATTAGTA -> GGGATTAGTAA
TGGGCGATCCA -> GGGCGATCCAC
TGGGCTCACCT -> GGGCTCACCTA
TGGGGACCTCT -> GGGGACCTCTT
TGGGGAGCTAT -> GGGGAGCTATA
TGGGGATCCCC -> GGGGATCCCCC
TGGGGTATTGA -> GGGGTATTGAC
TGGGGTTAGCC -> GGGGTTAGCCT
TGGGTATTCCC -> GGGTATTCCCG
TGGGTCTGCGC -> GGGTCTGCGCA
TGGTACCACTG -> GGTACCACTGA
TGGTACTGGGT -> GGTACTGGGTC
TGGTATACTGC -> GGTATACTGCT
TGGTATATATC -> GGTATATATCG
TGGTATGGTAC -> GGTATGGTACC
TGGTATTCTCT -> GGTATTCTCTT
TGGTCCTTTCT -> GGTCCTTTCTA
TGGTCGGTTAT -> GGTCGGTTATT
TGGTGTGCCTC -> GGTGTGCCTCG
TGTACTCTCGG -> GTACTCTCGGA
TGTAGTACGGT -> GTAGTACGGTA
TGTCCCCGCAA -> GTCCCCGCAAC
TGTCTACGTTG -> GTCTACGTTGG
TGTCTACTTAT -> GTCTACTTATA
TGTCTGGGATG -> GTCTGGGATGG
TGTCTTTGTAG -> GTCTTTGTAGT
TGTGCCTCGCT -> GTGCCTCGCTG
TGTGCGTACCA -> GTGCGTACCAT
TGTGTTACGAT -> GTGTTACGATG
TGTTACGATGT -> GTTACGATGTT
TGTTCCCCGAT -> GTTCCCCGATG
TGTTCGATGGA -> GTTCGATGGAT
TGTTGGGCTCA -> GTTGGGCTCAC
TGTTGGGGATC -> GTTGGGGATCC
TGTTTCGGTCG -> GTTTCGGTCGA
TTAAAACCCTA -> TAAAACCCTAG
TTAAAGTCAAA -> TAAAGTCAAAC
TTAACAATCTT -> TAACAATCTTT
TTAACGTGTGC -> TAACGTGTGCG
TTAAGTCATTG -> TAAGTCATTGA
TTAAGTTAAAG -> TAAGTTAAAGT
TTACCGTGAAG -> TACCGTGAAGG
TTACGATGTTC -> TACGATGTTCC
TTACGCGGCAT -> TACGCGGCATG
TTACGCGTGCT -> TACGCGTGCTG
TTACGCTTGAA -> TACGCTTGAAC
TTACGGAACTT -> TACGGAACTTT
TTAGAGAAATC -> TAGAGAAATCA
TTAGAGTCAGG -> TAGAGTCAGGG
TTAGCCTTGAC -> TAGCCTTGACA
TTAGGTAAACC -> TAGGTAAACCT
TTAGTAAACTC -> TAGTAAACTCC
TTAGTGAATAG -> TAGTGAATAGA
TTAGTGCTCAT -> TAGTGCTCATT
TTAGTGTTGGG -> TAGTGTTGGGC
TTATAGCCAAC -> TATAGCCAACC
TTATCCCACGA -> TATCCCACGAG
TTATGTCCCCG -> TATGTCCCCGC
TTATTAGTGAA -> TATTAGTGAAT
TTCATAGACTC -> TCATAGACTCA
TTCCACGGAGC -> TCCACGGAGCA
TTCCACGGGCT -> TCCACGGGCTG
TTCCCCGATGA -> TCCCCGATGAA
TTCCCGGTTAC -> TCCCGGTTACG
TTCCGCTTGCC -> TCCGCTTGCCG
TTCCGTCCGAC -> TCCGTCCGACC
TTCCTCGCCGT -> TCCTCGCCGTA
TTCCTGGAAGT -> TCCTGGAAGTT
TTCCTTGTTGG -> TCCTTGTTGGG
TTCGACTGAGT -> TCGACTGAGTT
TTCGATGGATT -> TCGATGGATTT
TTCGCAGCGTG -> TCGCAGCGTGA
TTCGCATACTT -> TCGCATACTTA
TTCGCGACAAG -> TCGCGACAAGC
TTCGCGGAACT -> TCGCGGAACTG
TTCGGTCGATG -> TCGGTCGATGA
TTCGTGAACAC -> TCGTGAACACA
TTCTAACGTAT -> TCTAACGTATA
TTCTCATTGCC -> TCTCATTGCCG
TTCTCCGCTCC -> TCTCCGCTCCC
TTCTCTTGGCC -> TCTCTTGGCCA
TTCTTTACGCT -> TCTTTACGCTT
TTGAAACCGAA -> TGAAACCGAAG
TTGAAACCGGC -> TGAAACCGGCT
TTGAACTGTTC -> TGAACTGTTCG
TTGAAGGGTAC -> TGAAGGGTACC
TTGACACGGCC -> TGACACGGCCG
TTGACAGTAAT -> TGACAGTAATA
TTGACGTGAAT -> TGACGTGAATG
TTGAGAAATCG -> TGAGAAATCGG
TTGAGCCTCTC -> TGAGCCTCTCT
TTGAGTCAGGG -> TGAGTCAGGGA
TTGATTGGCTC -> TGATTGGCTCA
TTGCAACCATG -> TGCAACCATGC
TTGCACAACAA -> TGCACAACAAC
TTGCCCCGATA -> TGCCCCGATAC
TTGCCGAGTAG -> TGCCGAGTAGG
TTGCCGCAATT -> TGCCGCAATTA
TTGCCGGCCTC -> TGCCGGCCTCG
TTGCCGGGTCG -> TGCCGGGTCGA
TTGCCTGCAGT -> TGCCTGCAGTT
TTGCGTCGAGT -> TGCGTCGAGTG
TTGGAGTTGAA -> TGGAGTTGAAA
TTGGCCACTGC -> TGGCCACTGCG
TTGGCTCAGTC -> TGGCTCAGTCT
TTGGGCTCACC -> TGGGCTCACCT
TTGGGGATCCC -> TGGGGATCCCC
TTGGTATACTG -> TGGTATACTGC
TTGGTATTCTC -> TGGTATTCTCT
TTGGTGTGCCT -> TGGTGTGCCTC
TTGTAGTACGG -> TGTAGTACGGT
TTGTCTGGGAT -> TGTCTGGGATG
TTGTTGGGGAT -> TGTTGGGGATC
TTTAACAATCT -> TTAACAATCTT
TTTACGCGTGC -> TTACGCGTGCT
TTTACGCTTGA -> TTACGCTTGAA
TTTAGTGTTGG -> TTAGTGTTGGG
TTTATGTCCCC -> TTATGTCCCCG
TTTCCTGGAAG -> TTCCTGGAAGT
TTTCGCATACT -> TTCGCATACTT
TTTCGCGGAAC -> TTCGCGGAACT
TTTCGGTCGAT -> TTCGGTCGATG
TTTCTAACGTA -> TTCTAACGTAT
TTTCTCCGCTC -> TTCTCCGCTCC
TTTCTTTACGC -> TTCTTTACGCT
TTTGAGTCAGG -> TTGAGTCAGGG
TTTGCCCCGAT -> TTGCCCCGATA
TTTGGTATTCT -> TTGGTATTCTC
TTTGTAGTACG -> TTGTAGTACGG
TTTTACGCGTG -> TTTACGCGTGC
TTTTAGTGTTG -> TTTAGTGTTGG
TTTTATGTCCC -> TTTATGTCCCC
TTTTCCTGGAA -> TTTCCTGGAAG
TTTTTCCTGGA -> TTTTCCTGGAA
TTTTTTCCTGG -> TTTTTCCTGGA
